SubscriptionText=SUBSCRIPTION
SubscriptionSuccessMessage=You have been successfully subscribed!
PageTitle=Automation Exercise
productName=Winter Top
CartText=Shopping Cart
DeliveryAddress=. Nisha gupta\nRanchi\nranchi jharkhand 124354\nUnited States\n1234546
BillingAddress=. Nisha gupta\nRanchi\nranchi jharkhand 124354\nUnited States\n1234546
ordercon=ORDER PLACED!
Delacc=ACCOUNT DELETED!
mensection=MEN - TSHIRTS PRODUCTS
category=CATEGORY
title = Automation Exercise - All Products
brandtext = Brands
prod=ALL PRODUCTS
review = WRITE YOUR REVIEW
reviewsuccess = Thank you for your review.
recommended = RECOMMENDED ITEMS
subs=SUBSCRIPTION
scrollup=Full-Fledged practice website for Automation Engineers
signup=ENTER ACCOUNT INFORMATION
Acc_cre = ACCOUNT CREATED!
contact = GET IN TOUCH
con_success = Success! Your details have been submitted successfully.
product = All Products
prod_nm = Blue Top
price = Rs. 500
brand = Polo
search_prod = SEARCHED PRODUCTS
brandname = BRAND - BIBA PRODUCTS
polobrand = BRAND - POLO PRODUCTS